

NO ./texture/textureN.xpm




EA ./texture/textureE.xpm




WE ./texture/textureE.xpm


F       		220,100,0
SO ./texture/textureE.xpm






C 






        1111111111111111111111111
        1000000000110001000000001
        1011000001110001000000001
        1001000000000000000001001
111111111011000001110N00000000001
100000000011000001110111111111111
11110111111111011100000010001
11110111111111011101010010001
11000000110111011100000010001
10000000000000001100000010001
10000000000000001101010010001
1100000111010101111101111000111
11110111 1110101 101111010001
11111111 1111111 111111111111





